11111111111
1P0C1C11101
11101000001
1C001010101
101000H0101
10111111101
10100C1C0V1
10C01E11C11
11111111111
