1111111111111
1C01000C00001
100C011110H01
1PV011E0000C1
1111111111111
